Therefore, in this motion for a resolution we call on the 1Council1 not only to renew existing 2sanctions2 for a further year but also to expand the sanctions to include EU visa bans and the freezing of 3assets3 held in the EU by a number of top officials in the Uzbekistani Government.	Tämän vuoksi kehotamme tässä päätöslauselmaesityksessä 1neuvostoa1valtuustoa1 paitsi jatkamaan nykyisiä 2pakotteita2sanktioita2 vuodella myös laajentamaan niitä käsittämään EU:n viisumin epäämisen muutamilta Uzbekistanin hallituksen korkeimmilta virkamiehiltä ja heidän EU:ssa olevien 3varojensa3rahojensa3 jäädyttämisen.
The justified 1condemnations1 from Europe are overtaken by a 2practice2 of a completely different nature.	Euroopan oikeutetusti antamien 1tuomitsevien lausuntojen1moitteiden1 tilalle on tullut aivan toisenlainen 2käytäntö2toimintatapa2.
Our vote against you and your 1Commission1 is therefore a vote in favour of peace, social Europe, democracy and also a new maturity for this 2Parliament2 of ours.	Äänestämällä teitä ja 1komissiotanne1toimikuntaanne1 vastaan äänestämme näin ollen rauhan, sosiaalisen Euroopan, demokratian sekä Euroopan 2parlamentin2kansanedustuslaitoksen2 uudenlaisen, kypsän lähestymistavan puolesta.
To give but one example, the 1common policy on climate change1 must be a component of the future 2cohesion policy2, and this must also be reflected in the choice of projects.	Vain yhden esimerkin mainitakseni totean, että 1yhteisen ilmastonmuutospolitiikan1yleisen ilmastonmuutospolitiikan1 on oltava osa tulevaa 2koheesiopolitiikkaa2yhdenmukaisuuspolitiikkaa2, mikä on otettava huomioon myös hankkeiden valinnassa.
It remains the case that the 1Commission1 would actually be much better placed to control the 2EU's funds2 itself, rather than via the EIB.	1Komissiolla1toimikunnalla1 olisi itse asiassa paremmat mahdollisuudet valvoa 2EU:n varoja2Euroopan unionin varoja2 itse kuin EIP:n välityksellä.
I say again today what I said yesterday: if our House is weak, then so is yours, because if the governments of Europe do not respect us, they will not respect you or the independence of your 1College1.	Toistan tänään sen, mitä sanoin eilen: jos parlamentti on heikko, niin on komissiokin, koska jos Euroopan hallitukset eivät kunnioita meitä, ne eivät kunnioita myöskään teitä tai 1kollegionne1yliopistonne1 riippumattomuutta.
1Substances1 that cause allergies, not in everyone, but in certain people who cannot resist them, simply have no place in 2detergents2.	2Detergenteissä2puhdistusaineissa2 ei todellakaan ole tilaa 1ainesosille1aineksille1, jotka aiheuttavat allergioita - eivät kaikille, vaan niille, jotka eivät ole hajusteille vastustuskykyisiä.
Where Europe falls down is in the ability to convert this tradition, this knowledge, into 1opportunities for growth1, above all by improving the links between the 2academic world2 and the world of production.	Sen sijaan Euroopalta puuttuu kyky muuntaa tämä perinne ja tämä tieto 1kasvumahdollisuuksiksi1kasvun edellytyksiksi1 parantamalla ennen kaikkea 2tieteen maailman2tiedemaailman2 ja tuotannon maailman välistä yhteyttä.
This 1directive1 really does improve considerably the protection of 2accident victims2 outside their country of residence.	Tällä 1direktiivillä1ohjeistuksella1 todellakin parannetaan olennaisesti 2onnettomuuteen joutuvien henkilöiden2onnettomuuksien uhrien2 suojaa asuinmaan ulkopuolella.
It is necessary to ensure that the 1substances1 for which a claim is made have been shown to have a beneficial 2nutritional2 or physiological effect.	On tarpeen varmistaa, että niiden 1aineiden1ainesosien1, joista väite esitetään, suotuisat 2ravitsemukselliset2ravitsemukseen liittyvät2 tai fysiologiset vaikutukset on osoitettu.
I very much hope that this 1House1 will support that amendment.	Toivon todella, että 1parlamentti1talo1 tukee tätä tarkistusta.
The only solution is to ensure stricter 1police control1, as well as 2border controls2, and to release the names of companies which violate 3animal rights3 to the public, so that consumers might avoid them.	Ainoa ratkaisu on varmistaa tiukempi 1poliisin valvonta1poliisin kontrolli1 ja 2rajatarkastukset2rajavalvonta2 sekä julkistaa niiden yhtiöiden nimet, jotka loukkaavat 3eläinten oikeuksia3eläimille kuuluvia oikeuksia3, jotta kuluttajat voivat välttää niiden tuotteiden ostamista.
Madam 1President1, I am well aware of these real problems.	Arvoisa 1puhemies1presidentti1, nämä todelliset ongelmat ovat hyvin tiedossani.
We can at times hide behind the 1provisions1 of the 5Dublin Convention5, which states that the first 2EU country2 that an 3asylum seeker3 enters must process their 4application for asylum4.	Joissakin tapauksissa voimme piiloutua 5Dublinin yleissopimuksen5Dublinin sopimuksen5 1määräysten1ehtojen1 taakse, joiden mukaan ensimmäisen 2EU-maan2EU:hun kuuluvan maan2, johon 3turvapaikanhakija3turvapaikkaa hakeva3 saapuu, on käsiteltävä hänen 4turvapaikkahakemuksensa4turvapaikkapyyntönsä4.
Accordingly, we recommend the 1rejection1 of this request.	Tämän vuoksi suosittelemme 1hylkäämistä1eväämistä1.
We are analysing those 1measures1 closely and will comment on them in our first 2annual report2.	Tutkimme tarkkaan näitä 1toimenpiteitä1toimia1 ja kommentoimme niitä ensimmäisessä 2vuosittaisessa kertomuksessamme2vuosikertomuksessamme2.
The ‘involvement of ... 1non-citizens1 in elections', that is to say 2foreigners'2 4right to vote4, destroys the very principle of 3nationality3.	"1kansalaisuutta vailla olevien henkilöiden1muiden kuin kansalaisten1 osallistumisella vaaleihin", eli 2ulkomaalaisten2vierasmaalaisten2muunmaalaisten2 4äänioikeudella4äänestysoikeudella4oikeudella äänestää4, tuhotaan koko 3kansalaisuuden3kansallisuuden3 käsite.
I must stress that only if Parliament receives a 1report1 enabling it to assess the system will it be able to carry out its 2duties2 as a 3legislative body3 and a 4budgetary authority4.	Minun on korostettava, että parlamentti voi huolehtia 2tehtävistään2velvollisuuksistaan2 3lakiasäätävänä elimenä3lainsäädäntöelimenä3lakeja säätävänä elimenä3 ja 4budjettivallan4budjetointivallan4 käyttäjänä vain, jos se saa 1kertomuksen1raportin1, jonka perusteella se voi arvioida järjestelmää.
Despite this 1amendment1, the compromise reached fully meets the 2transparency requirement2, whilst taking into account the interests of 3passengers3 and also airlines, and so I and my group cannot support the 4rapporteur's4 new amendments, Amendments 54 and 55.	Tästä 1tarkistuksesta1lisäyksestä1 huolimatta saavutettu kompromissi täyttää täysin 2avoimuusvaatimuksen2rehellisyysvaatimuksen2, ja siinä otetaan huomioon sekä 3matkustajien3matkaajien3 että lentoyhtiöiden edut. Minä ja ryhmäni emme voi näin ollen kannattaa 4esittelijän4raportoijan4 uusia tarkistuksia 54 ja 55.
With regard to political legitimacy, Mr Wurtz, decisions relating to 1competition policy1 are taken in the individual Member States at 2national level2 by bodies which do not have the 3political legitimacy3 which the European Commission has conferred on it at 4European level4 by the European Parliament, in particular, with individual hearings for each Commissioner.	Jäsen Wurtz, mitä tulee poliittiseen legitiimiyteen, 1kilpailupolitiikkaa1kilpailukäytäntöjä1 koskevat päätökset tehdään yksittäisissä jäsenvaltioissa 2kansallisella tasolla2maan tasolla2, ja niistä vastaavilla elimillä ei ole samanlaista 3poliittista legitiimiyttä3poliittista arvovaltaa3  kuin Euroopan komissiolla, jonka poliittinen legitiimiys perustuu 4EU:n tasolla4eurooppalaisella tasolla4 Euroopan parlamentin antamaan valtuutukseen, jota antaessaan parlamentti voi kuulla jokaista komission jäsentä erikseen.
We could see in Burgenland, which borders on Hungary, that the 1Euro-sceptics1 did not stand a chance and were losing more and more ground.	Itävallan Burgenlandissa, Unkarin rajalla, näkyi, että 1laajentumista vastustavilla voimilla1euroskeptikoilla1EU-kriittisillä1 ei ollut mitään mahdollisuuksia ja että ne menettivät jatkuvasti asemiaan.
1Kyoto1 runs out in two years, but we need certainty and time to adapt.	1Kioto1Kioton sopimus1 umpeutuu kahden vuoden kuluttua, mutta me tarvitsemme varmuutta ja aikaa sopeutuaksemme.
So there is no additional 1room for manoeuvre1, which means that our ability to react in the event of a dramatic change in 2economic trends2 might be severely limited.	Ei siis ole olemassa ylimääräistä 1liikkumavaraa1joustovaraa1 ja ilman sitä toiminta voi tosiaan lamaantua 2suhdanteiden2taloustrendien2 äkillisesti muuttuessa.
My group endorses the proposal made by 2Mr2 Turco and 3Mr3 von Boetticher, and we approve the 1position1 they have taken.	Ryhmäni tukee 2jäsen2herra2 Turcon ja 3jäsen3herra3 von Boetticherin ehdotusta, ja hyväksymme heidän omaksumansa 1kannan1mielipiteen1.
Since the Second World War, the peoples of the world have given the UN Security Council many rights and a high degree of responsibility for security and for 1maintaining peace1.	Toisen maailmansodan jälkeen kansat ovat siirtäneet YK:n turvallisuusneuvostolle monia oikeuksia ja suuren vastuun turvallisuudesta ja 1rauhan säilyttämisestä1rauhan ylläpitämisestä1.
Yet they are vital for our future, the future of 2Europe2, the future of our 1youth1.	Ne ovat kuitenkin olennaisen tärkeitä tulevaisuudellemme, 2EU:n2Euroopan2 tulevaisuudelle, 1nuorisomme1nuortemme1 tulevaisuudelle.
We must ensure that these 1people1 are safe from harm on line.	Näitä 1ihmisiä1henkilöitä1 on suojeltava verkon haitoilta.
Mr 1President1, the current 2Cohesion policy2 started life with the 3title3 of the Lisbon Strategy.	(DE) Arvoisa 1puhemies1presidentti1, nykyinen 2koheesiopolitiikka2yhtenäisyyspolitiikka2 sai alkunsa 3otsikolla3nimellä3 Lissabonin strategia.
Finally, I feel the Commission must support us and press for these 1amendments1 with the Council.	Minusta tuntuu lopuksi siltä, että komission on tuettava meitä ja pantava neuvosto tiukille näiden 1tarkistusten1lisäysten1 kanssa.
Special clauses on protection are in force, and the new Member States are being monitored to ensure they meet their 1commitments1 in connection with assessing their readiness to become part of the Schengen area.	Voimassa on erityisiä suojelua koskevia lausekkeita, ja uusia jäsenvaltioita valvotaan, jotta niiden varmistetaan täyttävän 1sitoumuksensa1velvoitteensa1, kun arvioidaan niiden valmiutta liittyä Schengen-alueeseen.
In this case, the use of other 1technologies1, especially during the current 2crisis2, has not proved to be more effective.	Tässä tapauksessa muiden 1tekniikoiden1teknologioiden1 käyttö eritoten nykyisen 2kriisin2hätätilan2 aikana ei ole osoittautunut olevan nykyistä menetelmää tehokkaampaa.
I believe that dialogue is the means of choice because I doubt very much whether we would achieve the desired result if we started speaking about trade sanctions.	Mielestäni vuoropuhelu on tarvitsevamme keino, sillä epäilen vahvasti, että saavuttaisimme haluamamme tulokset, jos alkaisimme puhua kauppapakotteista.
To this end, we must focus our efforts on high-tech 1sectors1 such as health and 2biotechnology2, 3defence3 and space – the Galileo programme sets a good example in this respect – state-of-the-art 4telecommunications4 and 5renewable sources of energy5.	Tämän tavoitteen saavuttamiseksi meidän on keskitettävä toimemme korkean teknologian 1aloihin1sektoreihin1, kuten terveydenhoidon ja 2bioteknologian2biotekniikan2, 3puolustuksen3puolustusteollisuuden3 ja avaruustutkimuksen aloille – tästä on hyvänä esimerkkinä Galileo-ohjelma – sekä huipputeknisen 4tietoliikenteen4viestinnän4 ja 5uudistuvien energialähteiden5uusiutuvien energianlähteiden5 aloihin.
